000000000000000
000000000000000
000000000000000
000000000000000
000000000000000
000000000022200
000222222220200
000200000000200
000200000000200
000200000000200
000200000000200
000200000000200
000200000000200
122200000000200
000000000000300